0 0 0 t t t 0 0 t t 0 0 0 0
0 0 0 t t w w w w w w 0 0 0
0 0 t t t w w t w w w 0 0 0
0 0 t 0 0 w w w w w t t 0 0
t t t 0 0 w t t t 0 0 t 0 0
t t t w w w t g t 0 0 t t t
t t t 0 0 0 t t t 0 0 t s t
t t 0 0 0 0 0 0 0 0 0 t t t
t t 0 0 0 0 0 0 0 0 t t t 0
t t t w t t t t w t t t t 0