0 0 0 0 0 0 0 0 0 0 0 g t t t 0 0 0 0
0 0 0 0 0 0 0 0 t t 0 0 0 0 t t t t 0
0 0 0 0 0 0 0 0 t t 0 0 0 0 t t t t 0
0 t t s 0 0 t t t t t t t t t t t t t
0 t t t t t t t t 0 0 0 0 0 0 t 0 0 0
0 0 0 t t t t t t 0 0 0 0 0 0 0 0 0 0