t t t t t t t
t 0 0 t t g t
t t 0 0 t t t
t t t 0 0 0 0
t s t 0 0 0 0
t t t 0 0 0 0