0 0 0 0 0 0 0 0 0 0 t t t
0 0 0 0 0 0 0 0 0 0 t g t
0 0 0 0 0 0 0 0 0 0 t t t
0 0 0 0 0 0 0 0 0 0 0 t 0
0 0 0 0 0 0 0 0 0 0 0 t 0
0 0 0 0 0 0 0 0 0 0 0 t 0
0 0 0 0 0 0 0 0 0 0 0 t 0
0 0 0 0 0 0 0 0 0 0 0 t 0
t t t 0 0 0 0 0 0 0 t t t
t s t t t t t t t t t t t
t t t 0 0 0 0 0 0 0 t t t