t t s 0 0 0 0 0
t t t t t 0 0 0
0 0 t t t 0 0 0
0 0 t 0 0 0 0 0
0 0 t 0 0 0 0 0
0 0 t 0 0 0 0 0
0 0 t 0 0 0 0 0
0 0 t 0 0 0 0 0
0 0 t t t t g t
0 0 0 0 0 t t 0
0 0 0 0 0 t t 0