t t t t t t 0 0 0 0
t t t t t t 0 0 0 0
t 0 0 t t t t t 0 0
w 0 0 0 w 0 0 t t t
t 0 0 0 w 0 0 t t t
t 0 0 0 w w w w w t
t 0 0 t t t w w w 0
t 0 0 t g t w t w 0
w 0 0 t t t w w w t
t 0 0 0 0 0 w w w t
t t 0 0 0 0 t w w 0
t t t t t t t 0 0 0
t t t s t 0 0 0 0 0
0 0 t t t 0 0 0 0 0