0 0 0 0 0 0 0 0 g 0
t t 0 0 0 0 0 0 t t
t t t t 0 0 0 0 t 0
s t t t 0 t t t t 0
0 0 t t t 0 t t 0 0
0 0 t t t t t t 0 0
0 t t 0 t 0 0 0 0 0
0 t t t t t t 0 0 0
0 t t t 0 0 0 0 0 0
0 t 0 0 0 0 0 0 0 0
0 t 0 0 0 0 0 0 0 0
0 t 0 0 0 0 0 0 0 0