0 0 0 0 0 0 t t t
0 0 0 t t t t g t
t t t t t t t t t
t s t t t t 0 0 0
t t t 0 0 0 0 0 0