0 0 0 0 t t 0
0 0 0 0 s t g
0 0 0 0 t t 0
0 0 0 0 t t 0
0 t t t t t 0
t t t t t 0 0
t t t t 0 0 0